  NO ./texture.xpm

SO ./texture.xpm
WE ./texture.xpm
EA ./texture.xpm

F 255,0,255
C 0,255,0

 111
 1S1
 101
 101
11011
10001       1
10001      101
11111  1111111