  NO ./texture.xpm

SO ./texture.xpm
WE ./texture.xpm
EA ./texture.xpm

F 255,0,255
C 0,255,0

1111111
1010101
1000001       1
1E00001      101
1111111  1111111