NO ./texturen.xpm
SO                      ./textures.xpm
F 255,0,           255
C 0,255,0











WE ./texturew.xpm
EA ./texturee.xpm



        1111111111 1111111111111111
        100000000010000000001000001
        110000000000000000000100111
        10000000000000000000000001
1111111110000000000000000000000011
100000000000000000000000000001111
100000000000000100000000000001
10001000001111100000000000001
1000000001     10000000000001
1000100000111110E000000011001
10000000000000000001010000001
11010001110101011111011110101
11110111 11101110101111010001
11111111111111111111111111111